//MAP CONVERTED BY dmm2tgm.py THIS HEADER COMMENT PREVENTS RECONVERSION, DO NOT REMOVE
"g" = (
/mob/living/basic/bat,
/turf/open/misc/dirt/station,
/area/space/nearstation)
"k" = (
/obj/effect/turf_decal/weather/dirt{
	dir = 1
	},
/obj/machinery/atmospherics/pipe/smart/manifold4w/supply/hidden/layer4,
/obj/machinery/atmospherics/components/unary/vent_scrubber/on/layer2,
/turf/open/floor/grass,
/area/space/nearstation)
"l" = (
/obj/structure/wall_torch/directional/west,
/obj/structure/flora/rock/pile/jungle/style_4,
/obj/modular_map_connector,
/turf/open/misc/dirt/station,
/area/space/nearstation)
"s" = (
/obj/structure/closet/crate,
/obj/effect/decal/cleanable/cobweb/cobweb2,
/obj/item/stack/ore/iron{
	amount = 6
	},
/obj/item/stack/ore/glass/basalt{
	amount = 8
	},
/obj/item/stack/sheet/mineral/coal,
/obj/effect/turf_decal/weather/dirt{
	dir = 9
	},
/turf/open/floor/grass,
/area/space/nearstation)
"u" = (
/obj/structure/wall_torch/directional/east,
/obj/structure/flora/rock/pile/jungle/style_5,
/obj/item/spear/bonespear,
/turf/open/misc/dirt/station,
/area/space/nearstation)
"v" = (
/turf/closed/mineral/random/jungle,
/area/space/nearstation)
"w" = (
/obj/structure/flora/grass/jungle,
/turf/open/floor/grass,
/area/space/nearstation)
"x" = (
/obj/effect/decal/remains/human,
/turf/open/misc/dirt/station,
/area/space/nearstation)
"F" = (
/obj/machinery/atmospherics/components/unary/vent_pump/on/layer4,
/turf/open/misc/dirt/station,
/area/space/nearstation)
"G" = (
/obj/structure/barricade/wooden/crude,
/turf/open/misc/dirt/station,
/area/space/nearstation)
"L" = (
/turf/open/misc/dirt/station,
/area/space/nearstation)

(1,1,1) = {"
L
v
v
l
G
F
k
"}
(2,1,1) = {"
g
u
x
L
v
s
w
"}
